NO ./Assets/LAVA/lava_1_diffuseOriginal.xpm
SO ./Assets/LAVA/lava_2_diffuseOriginal.xpm
WE ./Assets/LAVA/lava_3_diffuseOriginal.xpm
EA ./Assets/LAVA/lava_4_diffuseOriginal.xpm

F 220,100,0
C 225,30,0




        11111111111
        11111111111111111111111111
       1000000000110000000000001
      1011000001110000000000001
       1001000000000000000000001
111111111011000001110000000000001
10000000001100000111011111111111111111111111
11110111111111011100000010001
11110111111111011101010010001
1100000011010111100000010001
1000000N000000001100000010001
1000000000000001101010010001
1100000111010101111101111000111
11110111 1110101 101111010001
11111111 1111111 111111111111
